                  
##################
#              X #
#                #
#                #
#      ####      #
#     #    #     #
#     X          #
#                #
#                #
#                #
#     #    #     #
#      ####      #
##################
