
##################
#                #
#      #         #
#                #
#                #
#                #
#                #
#                #
#                #
#                #
#                #
#                #
##################
