                  
##################
#                #
#         X      #
#                #
#      ####      #
#     #    #     #
#                #
#                #
#        X       #
#                #
#     #    #     #
#      ####      #
##################
